PATTERNS AND EXTRACTS
SEMLEX
hamfarir:
	eldgos|eldgos
	jarðskjálfti|jarðskjálfti
	flóð|flóð
	snjóflóð|snjóflóð
	skjálfti|skjálfti
hitastig:
	hiti|hiti
	hitastig|hitastig
	gráða|gráða
	lofthiti|lofthiti
	frostmark|frostmark
staðsetning:
	vesturland|vesturland
	austurland|austurland
	reykjavík|reykjavík
	akureyri|akureyri
	suðurland|suðurland
tímasetning:
	morgunn|morgunn
	þriðjudagur|þriðjudagur
	helgi|helgi
	klukka|klukka
	kvöld|kvöld
veður:
	veður|veður
	rigning|rigning
	snjór|snjór
	snjókoma|snjókoma
	frost|frost
	sól|sól
manneskja:
	björgunarsveit|björgunarsveit
	lögregla|lögregla
	landhelgisgæsla|landhelgisgæsla
	slökkvilið|slökkvilið
	leitarhundur|leitarhundur
