aftakaveður|aftakaveður
akstursskilyrði|akstursskilyrði
asahláka|asahláka
aurskriða|aurskriða
austanátt|austanátt
bleyta|bleyta
blíðskaparveður|blíðskaparveður
blíðviðri|blíðviðri
bruni|bruni
bylur|bylur
dembur|dembur
drulla|drulla
fannfergi|fannfergi
flóð|flóð
frjókorn|frjókorn
frjótala|frjótala
frost|frost
frostmark|frostmark
fönn|fönn
grasfrjó|grasfrjó
haustveður|haustveður
himinn|himinn
hlýindi|hlýindi
hryðja|hryðja
hríð|hríð
hvassviðri|hvassviðri
hviða|hviða
hálka|hálka
hæglætisveðri|hæglætisveðri
hægviðrur|hægviðrur
jólaveður|jólaveður
krap|krap
krapi|krapi
kuldakast|kuldakast
kuldi|kuldi
langtímaspái|langtímaspái
langtímaveðurspá|langtímaveðurspá
loft|loft
loftslagsbreyting|loftslagsbreyting
loftstraumur|loftstraumur
lægð|lægð
mengun|mengun
meðalvindhraði|meðalvindhraði
meðalvindur|meðalvindur
meðalár|meðalár
norðanátt|norðanátt
norðaustanátt|norðaustanátt
norðaustur-|norðaustur-
norðvestanland|norðvestanland
ofankoma|ofankoma
ofsaveður|ofsaveður
rigning|rigning
rok|rok
sjór|sjór
skafl|skafl
skafrenningur|skafrenningur
skúr|skúr
snjóflóðahætta|snjóflóðahætta
snjóflóði|snjóflóði
snjókoma|snjókoma
snjór|snjór
snjóþyngsli|snjóþyngsli
spá|spá
spákort|spákort
stormur|stormur
strekkingsvindur|strekkingsvindur
strekkingur|strekkingur
strengur|strengur
styrkur|styrkur
stöð|stöð
sumarfæri|sumarfæri
sumarveður|sumarveður
sunnanátt|sunnanátt
suðvestanátt|suðvestanátt
sær|sær
síðdegisskúr|síðdegisskúr
síðdegisskúrir|síðdegisskúrir
sól|sól
sólarglenna|sólarglenna
sólarglæta|sólarglæta
sólbaðsveður|sólbaðsveður
sólskin|sólskin
súld|súld
tíðarfar|tíðarfar
umferð|umferð
veður|veður
veðurblíða|veðurblíða
veðurfar|veðurfar
veðurfarslýsing|veðurfarslýsing
veðurfræði|veðurfræði
veðurhamur|veðurhamur
veðurhæð|veðurhæð
veðurkort|veðurkort
veðurlag|veðurlag
veðurofsi|veðurofsi
veðurskilyrði|veðurskilyrði
veðurspá|veðurspá
veðurstofa|veðurstofa
veðurstofan|veðurstofan
vindhraði|vindhraði
vindhviða|vindhviða
vindstyrkur|vindstyrkur
vindur|vindur
von|von
vonskuveður|vonskuveður
væta|væta
átakaveður|átakaveður
átt|átt
él|él
ís|ís
ísing|ísing
ófærð|ófærð
ókyrrð|ókyrrð
óróahviða|óróahviða
óveður|óveður
óviðrur|óviðrur
úrfelli|úrfelli
úrhelli|úrhelli
úrkoma|úrkoma
þoka|þoka
þokuloft|þokuloft
þruma|þruma
þrýstingur|þrýstingur
slydduélja|slydduélja