apríl|apríl
aðfangadagur|aðfangadagur
aðfaranótt|aðfaranótt
birting|birting
dagsferð|dagsferð
dagur|dagur
desember|desember
eftirmiðdagur|eftirmiðdagur
eittleyti|eittleyti
febrúar|febrúar
fimmleyti|fimmleyti
fimmtudagskvöld|fimmtudagskvöld
fimmtudagsmorgunn|fimmtudagsmorgunn
fimmtudagur|fimmtudagur
framtíð|framtíð
fyrradagur|fyrradagur
fyrrakvöld|fyrrakvöld
fyrramál|fyrramál
fyrravetur|fyrravetur
fyrri|fyrri
fyrrinótt|fyrrinótt
föstudagskvöld|föstudagskvöld
föstudagur|föstudagur
gamlársdagur|gamlársdagur
gær|gær
gærdagur|gærdagur
gærkvöld|gærkvöld
gærmorgunn|gærmorgunn
gærnótt|gærnótt
haust|haust
heyskapartíð|heyskapartíð
hundadagur|hundadagur
hvítasunna|hvítasunna
hvítasunnuhelgi|hvítasunnuhelgi
hádegi|hádegi
hádegisbil|hádegisbil
hálftími|hálftími
janúar|janúar
janúarmánuður|janúarmánuður
jól|jól
jónsmessa|jónsmessa
júlí|júlí
júlímánuður|júlímánuður
júní|júní
kaffileyti|kaffileyti
klukka|klukka
klukkustund|klukkustund
klukkutími|klukkutími
kuldatíð|kuldatíð
kvöld|kvöld
kvöldmatarleyti|kvöldmatarleyti
laugardagskvöld|laugardagskvöld
laugardagsmorgunn|laugardagsmorgunn
laugardagur|laugardagur
leyti|leyti
mars|mars
marsmánuður|marsmánuður
maí|maí
maímánuður|maímánuður
miðnætti|miðnætti
miðvikudagskvöld|miðvikudagskvöld
miðvikudagur|miðvikudagur
morgundagur|morgundagur
morgunn|morgunn
morgunsár|morgunsár
mánaðamót|mánaðamót
mánudagsmorgunn|mánudagsmorgunn
mánudagur|mánudagur
mánuður|mánuður
mínúta|mínúta
nótt|nótt
nóvember|nóvember
október|október
októbermánuður|októbermánuður
páskahelgi|páskahelgi
páskar|páskar
sekúnda|sekúnda
september|september
septembermánuður|septembermánuður
sexleyti|sexleyti
sjómannadagur|sjómannadagur
sjöleyti|sjöleyti
sumar|sumar
sumardagur|sumardagur
sunnudagskvöld|sunnudagskvöld
sunnudagur|sunnudagur
síðdegi|síðdegi
sólarhringur|sólarhringur
sólskinsstund|sólskinsstund
tvöleyti|tvöleyti
tímabil|tímabil
tími|tími
tíuleyti|tíuleyti
verslunarmannahelgi|verslunarmannahelgi
vetrarlag|vetrarlag
vetur|vetur
vika|vika
vor|vor
ágúst|ágúst
ágústmánuður|ágústmánuður
ár|ár
árstími|árstími
árstíð|árstíð
önn|önn
öskudagur|öskudagur
þjóðhátíðardagur|þjóðhátíðardagur
þorri|þorri
þriðjudagskvöld|þriðjudagskvöld
þriðjudagur|þriðjudagur
þrjúleyti|þrjúleyti