alda|alda
almannahætta|almannahætta
aurskriða|aurskriða
aurskriður|aurskriður
aðstæður|aðstæður
banaslys|banaslys
beygja|beygja
bifreið|bifreið
bifreiði|bifreiði
björgun|björgun
björgunarbátur|björgunarbátur
björgunarsveitarbíll|björgunarsveitarbíll
björgunarvesti|björgunarvesti
brennisteinsmengun|brennisteinsmengun
brot|brot
bruni|bruni
bylgja|bylgja
bára|bára
bílslys|bílslys
dropi|dropi
eignatjón|eignatjón
eldgos|eldgos
eldhaf|eldhaf
elding|elding
eldsumbrot|eldsumbrot
eldsvoði|eldsvoði
flak|flak
flugatvik|flugatvik
flóð|flóð
framburður|framburður
framrúða|framrúða
framúrakstur|framúrakstur
gosvirkni|gosvirkni
grjót|grjót
grjóthrun|grjóthrun
hlaup|hlaup
hlaupastaður|hlaupastaður
hraun|hraun
hraungrýti|hraungrýti
hrun|hrun
hver|hver
hætta|hætta
hæð|hæð
jarðskjálftakippur|jarðskjálftakippur
jarðskjálfti|jarðskjálfti
jarðskjálftur|jarðskjálftur
jökulhlaupi|jökulhlaupi
kippur|kippur
kraftur|kraftur
krapaflóð|krapaflóð
krapaflóðahætta|krapaflóðahætta
krapaflóði|krapaflóði
krapaskriða|krapaskriða
krapi|krapi
kötluhlaupi|kötluhlaupi
landsbrot|landsbrot
leitarskilyrði|leitarskilyrði
leitarstarf|leitarstarf
ofanflóði|ofanflóði
reykur|reykur
richter|richter
rofmáttur|rofmáttur
sina|sina
sinubrunur|sinubrunur
skemmd|skemmd
skjálftahrina|skjálftahrina
skjálftamælur|skjálftamælur
skjálftasvæði|skjálftasvæði
skjálftavirkni|skjálftavirkni
skjálfti|skjálfti
skriða|skriða
slys|slys
smáskjálfti|smáskjálfti
snjóflóð|snjóflóð
snjóflóðahætta|snjóflóðahætta
snjóflóði|snjóflóði
sprenging|sprenging
sprunga|sprunga
sprunguveggur|sprunguveggur
stærð|stærð
stórgrýti|stórgrýti
stórhríðaveður|stórhríðaveður
stórtjón|stórtjón
stórviðri|stórviðri
tilfelli|tilfelli
tilkynning|tilkynning
tilvik|tilvik
tjónamat|tjónamat
umbrot|umbrot
umferðarslys|umferðarslys
umferðaróhapp|umferðaróhapp
vald|vald
vatnavöxtur|vatnavöxtur
vatnsflaumur|vatnsflaumur
velta|velta
vettvangur|vettvangur
virkni|virkni
viðvörun|viðvörun
viðvörunarskilti|viðvörunarskilti
áfallahjálp|áfallahjálp
árekstur|árekstur
íkveikja|íkveikja
óhapp|óhapp
öskufall|öskufall