afrétt|afrétt
alþingishús|alþingishús
annes|annes
austurhelmingur|austurhelmingur
austurhluti|austurhluti
austurland|austurland
bakki|bakki
borð|borð
botn|botn
brekka|brekka
bryggja|bryggja
brú|brú
brún|brún
bsí|bsí
byggð|byggð
bátur|bátur
bæjarhlað|bæjarhlað
bær|bær
bílastæði|bílastæði
bíll|bíll
bústaður|bústaður
dalur|dalur
djúp|djúp
dráttarbíll|dráttarbíll
egilsstaðaflugvellur|egilsstaðaflugvellur
eyja|eyja
eyjar|eyjar
fjall|fjall
fjallvegur|fjallvegur
fjara|fjara
fjárhús|fjárhús
fjórðungur|fjórðungur
fjölbýlishúsi|fjölbýlishúsi
fjörður|fjörður
flug|flug
flugbraut|flugbraut
flugfélag|flugfélag
flughæð|flughæð
flugvél|flugvél
flutningabíll|flutningabíll
flói|flói
félagsheimili|félagsheimili
fólksbifreiðir|fólksbifreiðir
fólksbíll|fólksbíll
gata|gata
gatnamóti|gatnamóti
geysissvæð|geysissvæð
gil|gil
grindavíkurhöfn|grindavíkurhöfn
göng|göng
hafnarbakki|hafnarbakki
hafnarfjarðarbær|hafnarfjarðarbær
heiði|heiði
hringvegur|hringvegur
hálendi|hálendi
hérað|hérað
hóll|hóll
hólmi|hólmi
höfn|höfn
höfuðborg|höfuðborg
höfuðborgarsvæði|höfuðborgarsvæði
hús|hús
húsnæði|húsnæði
innanlandsflug|innanlandsflug
innstrandavegur|innstrandavegur
innsveiti|innsveiti
jeppabifreið|jeppabifreið
jeppi|jeppi
jökull|jökull
jökulrönd|jökulrönd
jökulsá|jökulsá
jökulá|jökulá
jörð|jörð
keflavíkurflugvöllur|keflavíkurflugvöllur
km|km
kílómetri|kílómetri
land|land
landgrunn|landgrunn
landshluti|landshluti
landsvæði|landsvæði
leitarsvæði|leitarsvæði
leiti|leiti
láglendi|láglendi
lækjarbakki|lækjarbakki
lækur|lækur
lón|lón
lögreglujeppi|lögreglujeppi
m|m
meginland|meginland
metri|metri
millilandaflugi|millilandaflugi
miðborg|miðborg
miðbær|miðbær
mm|mm
na-strönd|na-strönd
norðausturhorn|norðausturhorn
norðausturland|norðausturland
norðurhluti|norðurhluti
norðurland|norðurland
norðurströnd|norðurströnd
norðvesturhluti|norðvesturhluti
nágrenni|nágrenni
pallbíll|pallbíll
reykjavíkurflugvöllur|reykjavíkurflugvöllur
ráðhústorg|ráðhústorg
rúta|rúta
sjúkrahús|sjúkrahús
skip|skip
skáli|skáli
skógur|skógur
slysadeild|slysadeild
slysstaður|slysstaður
snjóflóðasvæði|snjóflóðasvæði
staðsetning|staðsetning
staður|staður
strætisvagn|strætisvagn
strönd|strönd
suðausturland|suðausturland
suðausturströnd|suðausturströnd
suður|suður
suðurland|suðurland
suðurleið|suðurleið
suðvestur|suðvestur
suðvesturhorn|suðvesturhorn
suðvesturland|suðvesturland
sveit|sveit
sveitarfélag|sveitarfélag
svæði|svæði
tindur|tindur
tjörn|tjörn
togari|togari
toppur|toppur
tún|tún
umhverfi|umhverfi
uppsveit|uppsveit
vagn|vagn
vatn|vatn
vegur|vegur
vestfirðir|vestfirðir
vesturbær|vesturbær
vesturland|vesturland
vöruflutningabíll|vöruflutningabíll
vöruflutningaflugi|vöruflutningaflugi
á|á
áfangastaður|áfangastaður
íbúð|íbúð
ísland|ísland
ólafsvíkurkirkja|ólafsvíkurkirkja
ökutæki|ökutæki
þjóðvegur|þjóðvegur
þykkt|þykkt
þyrla|þyrla