afleysingarskipstjóri|afleysingarskipstjóri
austfirðingur|austfirðingur
aðstandendur|aðstandendur
björgunarmaður|björgunarmaður
björgunarsveit|björgunarsveit
björgunarsveitarmaður|björgunarsveitarmaður
borgarbúi|borgarbúi
borgarstjóri|borgarstjóri
bróðir|bróðir
bæjarbúi|bæjarbúi
bæjarstarfsmaður|bæjarstarfsmaður
bæjarstjóri|bæjarstjóri
bóndi|bóndi
deildarstjóri|deildarstjóri
einstaklingur|einstaklingur
eyjaskeggi|eyjaskeggi
farþegi|farþegi
faðir|faðir
ferðafólk|ferðafólk
ferðalangur|ferðalangur
ferðamaður|ferðamaður
fjölskylda|fjölskylda
flugmaður|flugmaður
formaður|formaður
forráðamaður|forráðamaður
forstjóri|forstjóri
forstöðumaður|forstöðumaður
félagi|félagi
fólk|fólk
gestur|gestur
göngufélagi|göngufélagi
hjálparsveit|hjálparsveit
hópur|hópur
höfuðborgarbúur|höfuðborgarbúur
húseigandi|húseigandi
jarðeðlisfræðingur|jarðeðlisfræðingur
jarðfræðingur|jarðfræðingur
jeppamaður|jeppamaður
kafari|kafari
karlmaður|karlmaður
kona|kona
landhelgisgæsla|landhelgisgæsla
landsmaður|landsmaður
leitarhundur|leitarhundur
leitarhópur|leitarhópur
lögregla|lögregla
lögreglumaður|lögreglumaður
lögreglustjóri|lögreglustjóri
maður|maður
reykvíkingur|reykvíkingur
sjúklingur|sjúklingur
skipstjóri|skipstjóri
skipverji|skipverji
skotveiðimaður|skotveiðimaður
skálavörður|skálavörður
slökkvilið|slökkvilið
slökkviliðsmaður|slökkviliðsmaður
snjóathugunarmaður|snjóathugunarmaður
snjómælingamaður|snjómælingamaður
starfsmaður|starfsmaður
stjörnufræðingur|stjörnufræðingur
sveitarstjóri|sveitarstjóri
tjaldgestur|tjaldgestur
varnarlið|varnarlið
varðstjóri|varðstjóri
vegagerðarmaður|vegagerðarmaður
vegfarandi|vegfarandi
veðurfræðingur|veðurfræðingur
veðurstofustjóri|veðurstofustjóri
viðmælandi|viðmælandi
yfirlögregluþjónn|yfirlögregluþjónn
yfirmaður|yfirmaður
ábúandi|ábúandi
áhöfn|áhöfn
íbúi|íbúi
íslendingur|íslendingur
ökumaður|ökumaður