afbrot	afbrot
atlöga	atlöga
bani	bani
bardagi	bardagi
barátta	barátta
byssa	byssa
bílsprengja	bílsprengja
fartölva	fartölva
handtaka	handtaka
handtöka	handtöka
handtökur	handtökur
hnífur	hnífur
hryðjuverk	hryðjuverk
hryðjuverka	hryðjuverka
hryðjuverkastarfsemi	hryðjuverkastarfsemi
hryðjuverkaárás	hryðjuverkaárás
hryðjuverkaárása	hryðjuverkaárása
hryðjuverkaárásir	hryðjuverkaárásir
húsleit	húsleit
innrási	innrási
kast	kast
morð	morð
rysking	rysking
sjálfsmorðssprengjuárás	sjálfsmorðssprengjuárás
sjálfsmorðsárás	sjálfsmorðsárás
sjálfsvígsárás	sjálfsvígsárás
sjálfsvígsárása	sjálfsvígsárása
skotbardagi	skotbardagi
skotbardögur	skotbardögur
slagur	slagur
slys	slys
sprenging	sprenging
sprenginga	sprenginga
sprengja	sprengja
sprengjubúnaður	sprengjubúnaður
sprengjuvesti	sprengjuvesti
sprengjuárás	sprengjuárás
stríð	stríð
sár	sár
vopn	vopn
voðaverk	voðaverk
yfirheyrsla	yfirheyrsla
áhlaup	áhlaup
árekstur	árekstur
árás	árás
árása	árása
árásir	árásir
ódæði	ódæði
óhapp	óhapp
afganistan	afganistan
albanía	albanía
anderlecht	anderlecht
austurríki	austurríki
azaz	azaz
aðalgata	aðalgata
bandaríki	bandaríki
bataclan	bataclan
belgía	belgía
berlín	berlín
birmingham	birmingham
borg	borg
borgarhluti	borgarhluti
boston-maraþon	boston-maraþon
breitscheidplatz-torgi	breitscheidplatz-torgi
breiðgata	breiðgata
bretland	bretland
brottfararsalur	brottfararsalur
brussel	brussel
brussels	brussels
brusselur	brusselur
bæjaralandi	bæjaralandi
bær	bær
bílaleiga	bílaleiga
búdapest	búdapest
chapell	chapell
charlerour	charlerour
charlottenburg	charlottenburg
charlottenburg-hverfi	charlottenburg-hverfi
danmörk	danmörk
edinborg	edinborg
egyptalandi	egyptalandi
evrópa	evrópa
evrópumeistaramóti	evrópumeistaramóti
fangelsi	fangelsi
farþegasæti	farþegasæti
felur	felur
ferð	ferð
ferðamannastaður	ferðamannastaður
fjölmiðill	fjölmiðill
flug	flug
flugbraut	flugbraut
flugskýli	flugskýli
flugstöð	flugstöð
flugstöðvarbygging	flugstöðvarbygging
flugvöllur	flugvöllur
flótti	flótti
frakkland	frakkland
fréttastofa	fréttastofa
fyrirtæki	fyrirtæki
garður	garður
gjörgæsla	gjörgæsla
gæsluvarðhald	gæsluvarðhald
gíslinga	gíslinga
hald	hald
heimahús	heimahús
heimaland	heimaland
heimili	heimili
heimsálfa	heimsálfa
heimur	heimur
hlaup	hlaup
hlið	hlið
holland	holland
hverfi	hverfi
háskóli	háskóli
hæli	hæli
höfuðborg	höfuðborg
hús	hús
innritunarborð	innritunarborð
jarðarför	jarðarför
jólamarkaður	jólamarkaður
jörð	jörð
kaupmannahöfn	kaupmannahöfn
kirkja	kirkja
kjallari	kjallari
kjarnorkuveri	kjarnorkuveri
kvikmyndahús	kvikmyndahús
land	land
landamærabær	landamærabær
lest	lest
loft	loft
london	london
lífshætta	lífshætta
maelbeek	maelbeek
maraþoni	maraþoni
matarverslun	matarverslun
mcdonalds-staður	mcdonalds-staður
minningarathöfn	minningarathöfn
miðborg	miðborg
miðjuvagn	miðjuvagn
moska	moska
münchen	münchen
neðanjarðarlest	neðanjarðarlest
neðanjarðarlestargöng	neðanjarðarlestargöng
neðanjarðarlestarstöð	neðanjarðarlestarstöð
nice	nice
norðurrín-vestfalía	norðurrín-vestfalía
norðvesturhluti	norðvesturhluti
nágrannaland	nágrannaland
nágrannalöndur	nágrannalöndur
nágrenni	nágrenni
pakistan	pakistan
parís	parís
pólland	pólland
rotterdam	rotterdam
ruslafata	ruslafata
ruslatunna	ruslatunna
ráðuneyti	ráðuneyti
ríki	ríki
safn	safn
schaarbeek	schaarbeek
schaarbeek-hverfi	schaarbeek-hverfi
shaerbeek	shaerbeek
sjónvarpsviðtal	sjónvarpsviðtal
skjalasafn	skjalasafn
skotland	skotland
skrifstofa	skrifstofa
sonboly	sonboly
spítali	spítali
stade	stade
staður	staður
stofnun	stofnun
suðurhluta-frakkland	suðurhluta-frakkland
svæði	svæði
sæti	sæti
sýrland	sýrland
sýrlandi	sýrlandi
tyrkland	tyrkland
tyrlandi	tyrlandi
túngata	túngata
vegur	vegur
verslunarmiðstöð	verslunarmiðstöð
vesturhluti	vesturhluti
vesturland	vesturland
vettvangur	vettvangur
viðverustaður	viðverustaður
wall	wall
zaventem	zaventem
zaventem-flugvöllur	zaventem-flugvöllur
álfa	álfa
ástralía	ástralía
átt	átt
íbúahverfi	íbúahverfi
íbúð	íbúð
írak	írak
ítalía	ítalía
öryggisstofnun	öryggisstofnun
útey	útey
úthverfi	úthverfi
þýskaland	þýskaland
bifreið	bifreið
bíll	bíll
farartæki	farartæki
farþegasæti	farþegasæti
flug	flug
flutningabíll	flutningabíll
fyrirtæki	fyrirtæki
lest	lest
lesta	lesta
mótorhjól	mótorhjól
neðanjarðarlest	neðanjarðarlest
trukkur	trukkur
vél	vél
vörubíll	vörubíll
alþingi	alþingi
alþjóðaflugvöllur	alþjóðaflugvöllur
bataclan	bataclan
bensínstöð	bensínstöð
brottfararsalur	brottfararsalur
brusselflugvellur	brusselflugvellur
bygging	bygging
bílaleiga	bílaleiga
charleroi-flugvellur	charleroi-flugvellur
charlerour	charlerour
disneyland	disneyland
fangelsi	fangelsi
fjölmiðill	fjölmiðill
flugbraut	flugbraut
flugskýli	flugskýli
flugstöð	flugstöð
flugstöðvarbygging	flugstöðvarbygging
flugvöllur	flugvöllur
heimahús	heimahús
heimili	heimili
háskóli	háskóli
hús	hús
jólamarkaður	jólamarkaður
kaffihús	kaffihús
kebabstaður	kebabstaður
kirkja	kirkja
kjallari	kjallari
kjarnorkuveri	kjarnorkuveri
kvikmyndahús	kvikmyndahús
lestarstöð	lestarstöð
louvre	louvre
maelbeek-neðanjarðarlestarstöð	maelbeek-neðanjarðarlestarstöð
malbeek-lestarstöða	malbeek-lestarstöða
matarverslun	matarverslun
matvöruverslun	matvöruverslun
mcdonalds-staður	mcdonalds-staður
moska	moska
neðanjarðarlestarstöð	neðanjarðarlestarstöð
ráðuneyti	ráðuneyti
safn	safn
sendiráð	sendiráð
sjúkrahús	sjúkrahús
skjalasafn	skjalasafn
skrifstofa	skrifstofa
strandhótel	strandhótel
tempelhof-flugvellur	tempelhof-flugvellur
vegur	vegur
verslunarmiðstöð	verslunarmiðstöð
völlur	völlur
zaventem-flugvelli	zaventem-flugvelli
zaventem-flugvellur	zaventem-flugvellur
zaventem-flugvöllur	zaventem-flugvöllur
íbúð	íbúð
al-bayan	al-bayan
al-qaeda	al-qaeda
bouzid	bouzid
bílstjóri	bílstjóri
cheffoa	cheffoa
chemla	chemla
daish	daish
faycal	faycal
faycall	faycall
hnífamaður	hnífamaður
hryðjuverkahópur	hryðjuverkahópur
hryðjuverkamaður	hryðjuverkamaður
hryðjuverkasamtök	hryðjuverkasamtök
hryðjuverkasamtöka	hryðjuverkasamtöka
hryðjuverkasamtöki	hryðjuverkasamtöki
hópur	hópur
höfuðpaurur	höfuðpaurur
isis	isis
kayall	kayall
lögregla	lögregla
lögregluyfirvald	lögregluyfirvald
mohamed	mohamed
ouali	ouali
róttækur	róttækur
saksóknar	saksóknar
salah	salah
samtök	samtök
sendiherra	sendiherra
sjálfsmorðssprengjumaður	sjálfsmorðssprengjumaður
sprengjumaður	sprengjumaður
stjórnandi	stjórnandi
stuðningsmaður	stuðningsmaður
sérfræðingur	sérfræðingur
talsmaður	talsmaður
utanríkisráðherra	utanríkisráðherra
utanríkisráðuneyti	utanríkisráðuneyti
vitorðsmaður	vitorðsmaður
vígahópur	vígahópur
vígamaður	vígamaður
vörubílstjóri	vörubílstjóri
yfirvald	yfirvald
zequiri	zequiri
árásarmaður	árásarmaður
öfgamaður	öfgamaður
öryggisstofnun	öryggisstofnun
alm(enningur	alm(enningur
eiginkona	eiginkona
frakki	frakki
fólk	fólk
fórnarlamb	fórnarlamb
guðjón	guðjón
hermaður	hermaður
látinn	látinn
látinn	látinn
lík	lík
manntjón	manntjón
maður	maður
myrtur	myrtur
nágranni	nágranni
predikari	predikari
ragnar	ragnar
róslínn	róslínn
sjónarvottur	sjónarvottur
skemmd	skemmd
starfsfólk	starfsfólk
stúlka	stúlka
særður	særður
vitni	vitni
íslendingur	íslendingur
Íslendingur	Íslendingur
þolandi)	þolandi)
