al-bayan|al-bayan
al-qaeda|al-qaeda
bouzid|bouzid
bílstjóri|bílstjóri
cheffoa|cheffoa
chemla|chemla
daish|daish
faycal|faycal
faycall|faycall
hnífamaður|hnífamaður
hryðjuverkahópur|hryðjuverkahópur
hryðjuverkamaður|hryðjuverkamaður
hryðjuverkasamtök|hryðjuverkasamtök
hryðjuverkasamtöka|hryðjuverkasamtöka
hryðjuverkasamtöki|hryðjuverkasamtöki
hópur|hópur
höfuðpaurur|höfuðpaurur
isis|isis
kayall|kayall
lögregla|lögregla
lögregluyfirvald|lögregluyfirvald
mohamed|mohamed
ouali|ouali
róttækur|róttækur
saksóknar|saksóknar
salah|salah
samtök|samtök
sendiherra|sendiherra
sjálfsmorðssprengjumaður|sjálfsmorðssprengjumaður
sprengjumaður|sprengjumaður
stjórnandi|stjórnandi
stuðningsmaður|stuðningsmaður
sérfræðingur|sérfræðingur
talsmaður|talsmaður
utanríkisráðherra|utanríkisráðherra
utanríkisráðuneyti|utanríkisráðuneyti
vitorðsmaður|vitorðsmaður
vígahópur|vígahópur
vígamaður|vígamaður
vörubílstjóri|vörubílstjóri
yfirvald|yfirvald
zequiri|zequiri
árásarmaður|árásarmaður
öfgamaður|öfgamaður
öryggisstofnun|öryggisstofnun