afganistan|afganistan
albanía|albanía
anderlecht|anderlecht
austurríki|austurríki
azaz|azaz
aðalgata|aðalgata
bandaríki|bandaríki
bataclan|bataclan
belgía|belgía
berlín|berlín
birmingham|birmingham
borg|borg
borgarhluti|borgarhluti
boston-maraþon|boston-maraþon
breitscheidplatz-torgi|breitscheidplatz-torgi
breiðgata|breiðgata
bretland|bretland
brottfararsalur|brottfararsalur
brussel|brussel
brussels|brussels
brusselur|brusselur
bæjaralandi|bæjaralandi
bær|bær
bílaleiga|bílaleiga
búdapest|búdapest
chapell|chapell
charlerour|charlerour
charlottenburg|charlottenburg
charlottenburg-hverfi|charlottenburg-hverfi
danmörk|danmörk
edinborg|edinborg
egyptalandi|egyptalandi
evrópa|evrópa
evrópumeistaramóti|evrópumeistaramóti
fangelsi|fangelsi
farþegasæti|farþegasæti
felur|felur
ferð|ferð
ferðamannastaður|ferðamannastaður
fjölmiðill|fjölmiðill
flug|flug
flugbraut|flugbraut
flugskýli|flugskýli
flugstöð|flugstöð
flugstöðvarbygging|flugstöðvarbygging
flugvöllur|flugvöllur
flótti|flótti
frakkland|frakkland
fréttastofa|fréttastofa
fyrirtæki|fyrirtæki
garður|garður
gjörgæsla|gjörgæsla
gæsluvarðhald|gæsluvarðhald
gíslinga|gíslinga
hald|hald
heimahús|heimahús
heimaland|heimaland
heimili|heimili
heimsálfa|heimsálfa
heimur|heimur
hlaup|hlaup
hlið|hlið
holland|holland
hverfi|hverfi
háskóli|háskóli
hæli|hæli
höfuðborg|höfuðborg
hús|hús
innritunarborð|innritunarborð
jarðarför|jarðarför
jólamarkaður|jólamarkaður
jörð|jörð
kaupmannahöfn|kaupmannahöfn
kirkja|kirkja
kjallari|kjallari
kjarnorkuveri|kjarnorkuveri
kvikmyndahús|kvikmyndahús
land|land
landamærabær|landamærabær
lest|lest
loft|loft
london|london
lífshætta|lífshætta
maelbeek|maelbeek
maraþoni|maraþoni
matarverslun|matarverslun
mcdonalds-staður|mcdonalds-staður
minningarathöfn|minningarathöfn
miðborg|miðborg
miðjuvagn|miðjuvagn
moska|moska
münchen|münchen
neðanjarðarlest|neðanjarðarlest
neðanjarðarlestargöng|neðanjarðarlestargöng
neðanjarðarlestarstöð|neðanjarðarlestarstöð
nice|nice
norðurrín-vestfalía|norðurrín-vestfalía
norðvesturhluti|norðvesturhluti
nágrannaland|nágrannaland
nágrannalöndur|nágrannalöndur
nágrenni|nágrenni
pakistan|pakistan
parís|parís
pólland|pólland
rotterdam|rotterdam
ruslafata|ruslafata
ruslatunna|ruslatunna
ráðuneyti|ráðuneyti
ríki|ríki
safn|safn
schaarbeek|schaarbeek
schaarbeek-hverfi|schaarbeek-hverfi
shaerbeek|shaerbeek
sjónvarpsviðtal|sjónvarpsviðtal
skjalasafn|skjalasafn
skotland|skotland
skrifstofa|skrifstofa
sonboly|sonboly
spítali|spítali
stade|stade
staður|staður
stofnun|stofnun
suðurhluta-frakkland|suðurhluta-frakkland
svæði|svæði
sæti|sæti
sýrland|sýrland
sýrlandi|sýrlandi
tyrkland|tyrkland
tyrlandi|tyrlandi
túngata|túngata
vegur|vegur
verslunarmiðstöð|verslunarmiðstöð
vesturhluti|vesturhluti
vesturland|vesturland
vettvangur|vettvangur
viðverustaður|viðverustaður
wall|wall
zaventem|zaventem
zaventem-flugvöllur|zaventem-flugvöllur
álfa|álfa
ástralía|ástralía
átt|átt
íbúahverfi|íbúahverfi
íbúð|íbúð
írak|írak
ítalía|ítalía
öryggisstofnun|öryggisstofnun
útey|útey
úthverfi|úthverfi
þýskaland|þýskaland