afbrot|afbrot
atlöga|atlöga
bani|bani
bardagi|bardagi
barátta|barátta
byssa|byssa
bílsprengja|bílsprengja
fartölva|fartölva
handtaka|handtaka
handtöka|handtöka
handtökur|handtökur
hnífur|hnífur
hryðjuverk|hryðjuverk
hryðjuverka|hryðjuverka
hryðjuverkastarfsemi|hryðjuverkastarfsemi
hryðjuverkaárás|hryðjuverkaárás
hryðjuverkaárása|hryðjuverkaárása
hryðjuverkaárásir|hryðjuverkaárásir
húsleit|húsleit
innrási|innrási
kast|kast
morð|morð
rysking|rysking
sjálfsmorðssprengjuárás|sjálfsmorðssprengjuárás
sjálfsmorðsárás|sjálfsmorðsárás
sjálfsvígsárás|sjálfsvígsárás
sjálfsvígsárása|sjálfsvígsárása
skotbardagi|skotbardagi
skotbardögur|skotbardögur
slagur|slagur
slys|slys
sprenging|sprenging
sprenginga|sprenginga
sprengja|sprengja
sprengjubúnaður|sprengjubúnaður
sprengjuvesti|sprengjuvesti
sprengjuárás|sprengjuárás
stríð|stríð
sár|sár
vopn|vopn
voðaverk|voðaverk
yfirheyrsla|yfirheyrsla
áhlaup|áhlaup
árekstur|árekstur
árás|árás
árása|árása
árásir|árásir
ódæði|ódæði
óhapp|óhapp