alþingi|alþingi
alþjóðaflugvöllur|alþjóðaflugvöllur
bataclan|bataclan
bensínstöð|bensínstöð
brottfararsalur|brottfararsalur
brusselflugvellur|brusselflugvellur
bygging|bygging
bílaleiga|bílaleiga
charleroi-flugvellur|charleroi-flugvellur
charlerour|charlerour
disneyland|disneyland
fangelsi|fangelsi
fjölmiðill|fjölmiðill
flugbraut|flugbraut
flugskýli|flugskýli
flugstöð|flugstöð
flugstöðvarbygging|flugstöðvarbygging
flugvöllur|flugvöllur
heimahús|heimahús
heimili|heimili
háskóli|háskóli
hús|hús
jólamarkaður|jólamarkaður
kaffihús|kaffihús
kebabstaður|kebabstaður
kirkja|kirkja
kjallari|kjallari
kjarnorkuveri|kjarnorkuveri
kvikmyndahús|kvikmyndahús
lestarstöð|lestarstöð
louvre|louvre
maelbeek-neðanjarðarlestarstöð|maelbeek-neðanjarðarlestarstöð
malbeek-lestarstöða|malbeek-lestarstöða
matarverslun|matarverslun
matvöruverslun|matvöruverslun
mcdonalds-staður|mcdonalds-staður
moska|moska
neðanjarðarlestarstöð|neðanjarðarlestarstöð
ráðuneyti|ráðuneyti
safn|safn
sendiráð|sendiráð
sjúkrahús|sjúkrahús
skjalasafn|skjalasafn
skrifstofa|skrifstofa
strandhótel|strandhótel
tempelhof-flugvellur|tempelhof-flugvellur
vegur|vegur
verslunarmiðstöð|verslunarmiðstöð
völlur|völlur
zaventem-flugvelli|zaventem-flugvelli
zaventem-flugvellur|zaventem-flugvellur
zaventem-flugvöllur|zaventem-flugvöllur
íbúð|íbúð